S-1-1-1-1-1-1
1-2-1-2-1-1-1
1-1-1-1-1-1-1
1-1-1-1-1-1-1
1-1-1-1-1-1-G
M(2,1,1)
M(2,1,2)
M(2,1,3)