S-1-1-2-1-1-1-1-2-1-1-1-1
1-2-1-1-1-2-1-1-1-1-1-1-1
1-1-#-1-2-1-#-1-1-1-1-1-1
1-1-1-1-1-1-1-1-1-1-1-1-1
2-1-1-2-1-2-2-1-1-2-1-1-1
1-1-1-1-1-1-1-2-1-1-1-1-1
1-1-1-1-2-1-2-1-1-1-1-1-1
1-2-1-1-1-1-1-1-2-1-1-1-1
2-1-1-1-2-1-1-1-1-G-1-1-1